1111
1001
1E01
1EC1
1P01
1111
