11111111111
10000000001
10000000001
10C00P00001
10000001001
111001E1001
1C100111001
11111111111
