11111111111
100C0000001
10000000001
1000C000001
10000000PC1
11100C00001
1E100000001
11111111111
