1111111111111111111111111111111111111111111
1C10000000000000000000CCC00000000000000E001
1010000000000000000000000000000000000000001
100000000000000000000P000000000000000000001
10000000C0000000000000000000000000000000001
1000000001C00000000000000000000000000000001
100000000CC00000000000000001C00000000000001
100000000000000000000000000CC00000000000001
1111C000000C1C000000000000000000CC000000001
100CC000000C0C0000000000000000001C000000001
1C0000000000000000000000000000000C000000001
1CCC000000000000000000000000000000000000001
1111111111111111111111111111111111111111111
