11111111111111111111
1P011C000111000111E1
10C101010011C1011001
1C0111C110110C101101
110C1000100100101001
1C0110C1100001100011
110C0001100100000001
11111111111111111111
