111111111111111111111111111111111111
100000000000000000000000000000000001
100000000000000000000000000000000001
100000000000000000000000000000000001
100000000000000000000000000000000001
1000000000CCCC0000CCC000000000000001
100000000C1111C00C111C00000000000001
10000000C1CCCC1CC1CCC1C0000000000001
1000000C1C0000C11C000C1C000000000001
1000000C1C00000CC0000C1C000000000001
10000000C1C000000000C1C0000000000001
100000000C1C000P000C1C00000000000001
1000000000C1C00000C1C000000000000001
10000000000C1C000C1C0000000000000001
100000000000C1C0C1C00000000000000001
1000000000000C1C1C000000000000000001
10000000000000CCC0000000000000000001
100000000000000C00000000000000000001
100000000000000E00000000000000000001
111111111111111111111111111111111111
