111111111111111111111111111111111111111111111111
1111111111111111111111111111111111CCCCCCC1111111
111111CCCCCCCC11111111111111111CCCCCCCCCCC111111
11111CCCCCCCCCCC11111111111111CCCCCCCCCCCCC11111
1111CCCCCCCCCCCCCCC111111111CCCCCCCCCCCCCCC11111
11CCCCCCCCCCCCCCCCCCC111111CCCCCCCCCCCCCCCCC1111
11CCCCCCCCCCCCCCCCCCCC1111CCCCCCCCCCCCCCCCCC1111
11CCCCCCCCCCCCCCCCCCCCC11CCCCCCCCCCCECCCCCCCC111
11CCCCCCCCCCCCCCCCCCCCC1CCCCCCCCCCCCCCCCCCCCC111
11CCCCCCCCCCCCCCCCCCCCCCCCCCCCCCCCCCCCCCCCCCC111
11CCCCCCCCCCCCCCCCCCCCCCCCCCCCCCCCCCCCCCCCCCC111
11CCCCCCCCCCCCCCCCCCCCCCCCCCCCCCCCCCCCCCCCCCC111
111CCCCCCCCCCCCCCCCCCCCCCCCCCCCCCCCCCCCCCCCCC111
111CCCCCCCCCCCCCCCCCCCCCPCCCCCCCCCCCCCCCCCCCC111
1111CCCCCCCCCCCCCCCCCCCCCCCCCCCCCCCCCCCCCCCC1111
1111CCCCCCCCCCCCCCCCCCCCCCCCCCCCCCCCCCCCCCCC1111
111111CCCCCCCCCCCCCCCCCCCCCCCCCCCCCCCCCCCCC11111
111111CCCCCCCCCCCCCCCCCCCCCCCCCCCCCCCCCCCC111111
1111111CCCCCCCCCCCCCCCCCCCCCCCCCCCCCCCCCCC111111
11111111CCCCCCCCCCCCCCCCCCCCCCCCCCCCCCCCC1111111
11111111CCCCCCCCCCCCCCCCCCCCCCCCCCCCCCCC11111111
111111111CCCCCCCCCCCCCCCCCCCCCCCCCCCCCC111111111
11111111111CCCCCCCCCCCCCCCCCCCCCCCCCCC1111111111
1111111111111CCCCCCCCCCCCCCCCCCCCCCCC11111111111
11111111111111CCCCCCCCCCCCCCCCCCCCC1111111111111
1111111111111111CCCCCCCCCCCCCCCCCC11111111111111
11111111111111111CCCCCCCCCCCCCCC1111111111111111
111111111111111111CCCCCCCCCCCC111111111111111111
11111111111111111111CCCCCCCC11111111111111111111
111111111111111111111CCCCCC111111111111111111111
1111111111111111111111CCCC1111111111111111111111
111111111111111111111111111111111111111111111111
