111111111111111111111111111111111111111111111111
100000000000000000000000000000000000000000000001
100000000000000000000000000000000000000000000001
100000000000000000000000111110000000000000000001
1000000001111111000000111CCC11100000000000000001
1000000011CCCCCC1110011CCCCCCC111000000000000001
100000001CCCCCCCCC1111CCCCCCCECC1100000000000001
100000001CCCCCCCCCC11CCCCCCCCCCCC100000000000001
1000000011CCCCCCCCC11CCCCCCCCCCCC100000000000001
10000000011CCCCCCCCC1CCCCCCCCCCCC100000000000001
110000000011CCCCCCCCCCCCCCCCCCCC1000000000000001
1100000000011CCCCCCCCCCCCCCCCCC11000000000000001
1100000000000111CCCCCCCCCCCCCC110000000000000001
110000000000000111CCCCCCCCCCCC100000000000000001
111000000000000000111CCCCCCC00000000000000000001
111000000000000000001111CCC111000000000000000001
1110000000000000000000011CC100000000000000000001
1110000000000000000000000110000000000000000000P1
111111111111111111111111111111111111111111111111
