1111111111111111111
1CCCCCCCC1CCCCCCCC1
1C11C111C1C111C11C1
1CCCCCCCCPCCCCCCCC1
1011C101111101C11C1
1CCCC1CCC1CCC1CCCC1
1111CCC1CCC1CCC1111
1CCCC1CCC1CCC1CC111
1CCCCCCCCCCCCCCCCE1
1111111111111111111
