1111111111
1P00000001
100CC0CC01
1001C00001
100C000001
100000C111
1110000CC1
10CC0000C1
1CC0000001
11C00000E1
1111111111
