111111111111111111111111111111
1000000000000000000000000000P1
1000001111000011111100000000C1
1000010000110110000111000000E1
100011000001110000000100000001
100001100000000000000100000001
100000110000000000001100000001
100000011100000000111000000001
100000000111000111000000000001
100000000001111100000000000001
100000000000110000000000000001
111111111111111111111111111111
