111111111111111
1000000000000111
111111111111111
